@@@@@@@@@@@@@@@
@             @
@             @
@      ab    g@
@            b@
@             @
@             @
@  cb         @
@             @
@             @
@             @
@             @
@             @
@             @
@@@@@@@@@@@@@@@