@@@@@@@@@@@@@@@
@af           @
@             @
@             @
@             @
@             @
@             @
@  c          @
@             @
@             @
@             @
@             @
@             @
@             @
@@@@@@@@@@@@@@@