@@@@@@@@@@@@@@@
@a            @
@             @
@            m@
@            b@
@             @
@             @
@  c          @
@             @
@             @
@             @
@             @
@             @
@             @
@@@@@@@@@@@@@@@
