@@@@@@@@@@@@@@@
@ab           @
@bb           @
@             @
@             @
@             @
@  b   m      @
@bbcbbf g     @
@  b   p      @
@             @
@             @
@             @
@             @
@             @
@@@@@@@@@@@@@@@