@@@@@@@@@@@@@@@
@am           @
@b            @
@b            @
@b            @
@             @
@             @
@  c          @
@             @
@             @
@             @
@             @
@             @
@             @
@@@@@@@@@@@@@@@