@@@@@@@@@@@@@@@
@ab           @
@bb           @
@             @
@             @
@             @
@  b          @
@bbcbb        @
@  b          @
@             @
@             @
@             @
@             @
@             @
@@@@@@@@@@@@@@@