@@@@@@@@@@@@@@@
@   f#        @
@    #        @
@a   #  p     @
@    ##### ###@
@    #   # #  @
@   ##   # #  @
@   b    #    @
@bbbb    #  c @
@        #  # @
@             @
@             @
@             @
@             @
@@@@@@@@@@@@@@@