@@@@@@@@@@@@@@@
@             @
@             @
@             @
@             @
@   a         @
@             @
@             @
@             @
@             @
@       c     @
@             @
@             @
@             @
@@@@@@@@@@@@@@@
