@@@@@@@@@@@@@@@
@             @
@             @
@             @
@             @
@    a        @
@  c          @
@             @
@             @
@             @
@             @
@             @
@             @
@             @
@@@@@@@@@@@@@@@
