@@@@@@@@@@@@@@@
@b            @
@b            @
@             @
@             @
@b   a        @
@  c          @
@             @
@b            @
@             @
@             @
@b            @
@             @
@b            @
@@@@@@@@@@@@@@@
