@@@@@@@@@@@@@@@
@             @
@             @
@             @
@             @
@             @
@             @
@  c          @
@        a    @
@             @
@             @
@             @
@             @
@             @
@@@@@@@@@@@@@@@
