###############
#     bbb     #
# # # #b# # # #
#             #
#b# # #b# # # #
#     bb    b #
#b# #b#b# # #b#
#     b b     #
# # #b#b#b# #b#
#     b bbb bb#
# # # #b#b# # #
#b       b    #
# # #b# # # #b#
#      bbb    #
###############