@@@@@@@@@@@@@@@
@     bbb     @
@ # # #b# # # @
@  a          @
@b# # #b# # # @
@     bb    b @
@b# #b#b# # #b@
@  c   b b    @
@ # #b#b#b# #b@
@     b bbb bb@
@ # # #b#b# # @
@b       b    @
@ # #b# # # #b@
@      bbb    @
@@@@@@@@@@@@@@@