@@@@@@@@@@@@@@@
@             @
@             @
@             @
@             @
@      a  c   @
@             @
@             @
@             @
@   m         @
@             @
@             @
@             @
@             @
@@@@@@@@@@@@@@@
