@@@@@@@@@@@@@@@
@             @
@             @
@             @
@     a       @
@             @
@   c         @
@             @
@             @
@             @
@             @
@             @
@             @
@             @
@@@@@@@@@@@@@@@
