@@@@@@@@@@@@@@@
@             @
@             @
@             @
@             @
@             @
@             @
@  a          @
@             @
@             @
@        c    @
@             @
@             @
@             @
@@@@@@@@@@@@@@@
