@@@@@@@@@@@@@@@
@             @
@             @
@             @
@   a    c    @
@             @
@             @
@ ###         @
@ f #         @
@   #         @
@   #         @
@   #         @
@             @
@             @
@@@@@@@@@@@@@@@
