@@@@@@@@@@@@@@@
@             @
@             @
@a        g   @
@             @
@             @
@             @
@ m           @
@            c@
@             @
@             @
@             @
@        p    @
@             @
@@@@@@@@@@@@@@@
