@@@@@@@@@@@@@@@
@         f   @
@bb bbb  bb   @
@     bbb b   @
@c       bb   @
@ #bbbb       @
@ #   b bb   a@
@ #   bbbb    @
@ #     b     @
@ #####       @
@     ######  @
@ b   p   #b# @
@ b   g   b   @
@             @
@@@@@@@@@@@@@@@
