@@@@@@@@@@@@@@@
@             @
@             @
@             @
@             @
@ a           @
@        c    @
@   bbbbb     @
@       bb    @
@         b   @
@  bbb   bb   @
@    bbbbb    @
@       b     @
@             @
@@@@@@@@@@@@@@@
