@@@@@@@@@@@@@@@
@bbbbbbbbbbbbb@
@b  b b      b@
@bbbb bbbbbbbb@
@b        b  b@
@b a      b  b@
@b   b  c b  b@
@bbb b    b  b@
@b b bbbbbb  b@
@b b         b@
@b b         b@
@b bbbbbbbbbbb@
@b           b@
@bbbbbbbbbbbbb@
@@@@@@@@@@@@@@@
