@@@@@@@@@@@@@@@
@             @
@             @
@             @
@             @
@             @
@      a      @
@             @
@             @
@             @
@             @
@             @
@             @
@             @
@@@@@@@@@@@@@@@
