@@@@@@@@@@@@@@@
@         c   @
@   ######    @
@        #    @
@         #   @
@ bbbbb   #   @
@ b       #   @
@ b   #  #    @
@ bb  a###    @
@  bbb        @
@    b        @
@             @
@             @
@             @
@@@@@@@@@@@@@@@
