@@@@@@@@@@@@@@@
@             @
@             @
@ a     g     @
@     b  b    @
@      bb g   @
@  b b   b    @
@    b        @
@     g       @
@           c @
@             @
@             @
@             @
@             @
@@@@@@@@@@@@@@@
