@@@@@@@@@@@@@@@
@  bb bbbbb   @
@         bb  @
@          b  @
@          b  @
@c     a   b  @
@          b  @
@          b  @
@         bb  @
@       bbb   @
@             @
@             @
@             @
@             @
@@@@@@@@@@@@@@@
