@@@@@@@@@@@@@@@
@             @
@             @
@  c          @
@             @
@             @
@             @
@             @
@             @
@       a     @
@             @
@             @
@             @
@             @
@@@@@@@@@@@@@@@
