@@@@@@@@@@@@@@@
@             @
@  bb bb      @
@ a bbb       @
@             @
@            c@
@             @
@     gg      @
@             @
@             @
@             @
@             @
@             @
@             @
@@@@@@@@@@@@@@@
