@@@@@@@@@@@@@@@
@       bbbb  @
@    bbb   b  @
@  bb bb b b  @
@        bbb  @
@a  bbbbb    c@
@   bbb       @
@       mm    @
@   mmmmmmm   @
@   mmm  mm   @
@    mmmm     @
@ mm   mmm    @
@ mmmmmm      @
@             @
@@@@@@@@@@@@@@@
