@@@@@@@@@@@@@@@
@ bbbbbbbbbbbb@
@ ##########  @
@    a        @
@             @
@          c  @
@             @
@             @
@             @
@             @
@             @
@             @
@             @
@             @
@@@@@@@@@@@@@@@
