@@@@@@@@@@@@@@@
@             @
@  bbbbbbbbb  @
@             @
@# ######### #@
@#   a  c    #@
@#           #@
@# bbbbbbbbb #@
@#           #@
@#           #@
@# ######### #@
@             @
@  bbbbbbbbb  @
@             @
@@@@@@@@@@@@@@@
