@@@@@@@@@@@@@@@
@             @
@  bbbbbbb    @
@         #   @
@ a  #    #   @
@   #     #   @
@         #  c@
@ #       #   @
@      #  #   @
@mmm      #   @
@             @
@        m    @
@             @
@             @
@@@@@@@@@@@@@@@
