@@@@@@@@@@@@@@@
@             @
@ ########### @
@ g         f @
@ ########### @
@             @
@ ########### @
@   a         @
@ bbbbbbbbbbb @
@             @
@ bbbbbbbbbbb @
@         c   @
@ bbbbbbbbbbb @
@             @
@@@@@@@@@@@@@@@
