@@@@@@@@@@@@@@@
@  #          @
@  #     #    @
@  #     #    @
@  # a   # c  @
@  #     #    @
@  #     #    @
@  #     #    @
@        # #  @
@####### # #  @
@      # # #  @
@      #   #  @
@      #####  @
@             @
@@@@@@@@@@@@@@@
