@@@@@@@@@@@@@@@
@b # bbbbbbbbb@
@b #     #   b@
@b #     #   b@
@b # a   # c b@
@  #     #    @
@  #     #    @
@  #     #    @
@        # #  @
@####### # #  @
@      # # #  @
@      #   #  @
@      #####  @
@bbbbbbbbbbbbb@
@@@@@@@@@@@@@@@
