@@@@@@@@@@@@@@@
@             @
@             @
@   ####      @
@       ##    @
@ b bbb  ##   @
@  a   bb #   @
@       b #   @
@mm   c b  #  @
@  mm   b     @
@       bbb   @
@    g        @
@     gg      @
@             @
@@@@@@@@@@@@@@@
