@@@@@@@@@@@@@@@
@abbbbbbbbbbb @
@ ########### @
@   bbbbbbb # @
@ # ####### # @
@ #   bbb # # @
@ # # ### # # @
@ # #   #c# # @
@ # # ### # # @
@ # # bbb # # @
@ # ####### # @
@ # bbbbbbb # @
@ ########### @
@ bbbbbbbbbbb @
@@@@@@@@@@@@@@@
