@@@@@@@@@@@@@@@
@ a b         @
@ # # #b# # # @
@        b   b@
@ # #b# # # # @
@  b  b g   b @
@b# # # # # # @
@  b  g  b   b@
@ # # # #b# #b@
@ b  b    b bb@
@ #b# # #b# # @
@    b   b  gc@
@ #b# # # # #b@
@    b  b   b @
@@@@@@@@@@@@@@@