###############
# a b         #
# # # #b# # # #
#        b   b#
# # #b# # # # #
#  b  b     b #
#b# # # # # # #
#  b     b   b#
# # # # #b# #b#
# b  b    b bb#
# #b# # #b# # #
#    b   b   c#
# #b# # # # #b#
#    b  b   b #
###############