@@@@@@@@@@@@@@@
@             @
@b###########b@
@ #           @
@ #b#########b@
@ # #         @
@ # ######### @
@ #b  c a  b# @
@ # ######### @
@ # #         @
@ #b#########b@
@ #         # @
@b###########b@
@             @
@@@@@@@@@@@@@@@
