@@@@@@@@@@@@@@@
@             @
@ #f####### # @
@ #         # @
@ # b bbb b # @
@ # b  c  b # @
@ # b  #  b # @
@ # b #b# b # @
@ # b  #  b # @
@ # b  a  b # @
@ # b bbb b # @
@ #         # @
@ # ####### # @
@             @
@@@@@@@@@@@@@@@
