###############
#  b     b    #
# # # # # # #b#
# a   b     b #
# # # #b# # # #
#b   b  b  b  #
#b# # # #b# # #
#  b     b   b#
# #b#b# # # #b#
# b  b  bb   c#
#b# # # # #b# #
#  b b  b     #
# #b# # #b# #b#
#    b  b  b  #
###############