@@@@@@@@@@@@@@@
@  b#p#  b    @
@ # # # # # #b@
@ #   b     b @
@ # ###b# # # @
@ba   b b  b  @
@b### # #b# # @
@  b     b   b@
@##b#b# # # #b@
@ b  b  bb   c@
@b# # # # #b# @
@  b b  b     @
@ #b# # #b# #b@
@    b  b  b  @
@@@@@@@@@@@@@@@